{
    "id":3,
    "doors": {
        "left": null,
        "right": null,
        "up": {"type": "kill_count", "complete": false, "num": 3, "colour": null},
        "down": null
    },
    "squares": [
        [1, 1, 1, 1, 7, 7, 1, 1, 1, 1],
        [1, 0, 0, 0, 0, 0, 0, 0, 0, 1],
        [1, 0, 0, 0, 0, 0, 0, 0, 0, 1],
        [1, 0, 0, 0, 0, 0, 0, 0, 0, 1],
        [1, 0, 0, 0, 0, 0, 0, 0, 0, 7],
        [1, 0, 0, 0, 10, 0, 0, 0, 0, 7],
        [1, 0, 0, 0, 0, 0, 0, 0, 0, 1],
        [1, 0, 0, 0, 0, 0, 0, 0, 0, 1],
        [1, 0, 0, 0, 0, 0, 0, 0, 0, 1],
        [1, 1, 1, 1, 1, 1, 1, 1, 1, 1]
    ],
    "entities": [
        {"name": "goblin",
        "x": 8,
        "y": 4
        }
    ]
}