{
    "id":2,
    "doors": {
        "left": null,
        "right": {"type": "kill_count", "complete": false, "num": 2, "colour": null},
        "up": null,
        "down": null
        
    },
    "squares": [
        [1, 1, 1, 1, 1, 1, 1, 1, 1, 1], 
        [1, 0, 0, 0, 0, 0, 0, 0, 0, 1], 
        [1, 0, 0, 0, 0, 0, 0, 0, 0, 1], 
        [1, 0, 0, 0, 0, 0, 0, 0, 0, 1], 
        [1, 0, 0, 0, 0, 0, 0, 0, 0, 7], 
        [1, 0, 0, 0, 0, 0, 0, 0, 0, 7], 
        [1, 0, 0, 0, 0, 0, 0, 0, 0, 1], 
        [1, 0, 0, 0, 0, 0, 0, 0, 0, 1], 
        [1, 0, 0, 0, 0, 0, 0, 0, 0, 1], 
        [1, 1, 1, 1, 1, 1, 1, 1, 1, 1]
    ],
    "entities": [
        {"name": "goblin",
        "x": 8,
        "y": 1
        },
        {"name": "goblin",
        "x": 8,
        "y": 8
        }
    ]
}