{
    "id":3,
    "doors": {
        "left": {"type": "kill_count", "complete": false, "num": 2, "colour": null},
        "right": null,
        "up": null,
        "down": null
    },
    "squares": [
        [1, 1, 1, 1, 1, 1, 1, 1, 1, 1],
        [1, 0, 0, 0, 0, 0, 0, 0, 0, 1],
        [1, 0, 0, 0, 0, 0, 0, 0, 0, 1],
        [1, 0, 0, 0, 0, 0, 0, 0, 0, 1],
        [7, 0, 0, 0, 0, 0, 0, 0, 0, 1],
        [7, 0, 0, 0, 2, 2, 0, 0, 0, 1],
        [1, 0, 0, 0, 0, 0, 0, 0, 0, 1],
        [1, 0, 0, 0, 0, 0, 0, 0, 0, 1],
        [1, 0, 0, 0, 0, 0, 0, 0, 0, 1],
        [1, 1, 1, 1, 1, 1, 1, 1, 1, 1]
    ],
    "entities": [
        {"name": "goblin",
        "x": 8,
        "y": 4
        }
    ]
}