{
    "id":7,
    "doors": {
        "left": null,
        "right": {"type": "kill_count", "complete": false, "num": 1, "colour": null},
        "up": null,
        "down": null
    },
    "squares": [
        [1, 1, 1, 1, 1, 1, 1, 1, 1, 1], 
        [1, 0, 0, 0, 0, 0, 0, 0, 0, 1], 
        [1, 0, 0, 0, 0, 0, 0, 0, 0, 1], 
        [1, 0, 0, 0, 0, 0, 0, 0, 0, 1], 
        [1, 0, 0, 0, 0, 0, 0, 0, 0, 7], 
        [1, 0, 0, 0, 0, 0, 0, 0, 0, 7], 
        [1, 0, 0, 0, 0, 0, 0, 0, 0, 1], 
        [1, 0, 0, 0, 0, 0, 0, 0, 0, 1], 
        [1, 0, 0, 0, 0, 0, 0, 0, 0, 1], 
        [1, 1, 1, 1, 1, 1, 1, 1, 1, 1]
    ],
    "entities": [
        {"name": "item", "x": 400, "y": 400, "item": "key", "payload": {"colour": [255, 100, 100, 100]}}
    ]
}